W W W W W W W W W W W W W W W W W W W
W S S S W S S S S W S S S S W S S S W
W S W S S S W W W W W W W S S S W S W
W S S S W S S S S S S S S S W S S S W
W W W W W S W W W 1 W W W S W W W W W
W S S S S S S S S S S S S S S S S S W
W S W W S W S W S W S W W W W W W S W
W S W S S W S S S S S S S W S S W S W
W S W S W W S W W E W W S S S W W W W
W S W S S W W W E P E W W W S S S S W
W 3 W W S S S W W E W W S W S W W S W
W S S S S W S S S S S S S W S W S S W
W S W W S W S W W W W W S W S W S W W
W S S S S S S S S W S S S S S W S S W
W W W W W S W S W W W S W S W W W W W
W S S S W S W S S W S S W S S S W S W
W W W S S S W W W S W W W S W W W S W
W S S S W S S S S 2 S S S S W S S S W
W W W S W W S W W W W W W S W W W S W
W S S S S W S S S S S S W S S S S S W
W W W W W W W W W W W W W W W W W W W