W W W W W W W W W W W W W W W W W W W
W S S S S S S S S S S S S S S S S S W
W B W S W S W S W S W S W S W S W B W
W S S W S W S W S W S W S W S W S S W
W S S S S S S S S S S S S S S S S S W
W S W S S S W S S W S W S W S S W 4 W
W S W S S W W W S W S W S W S W W W W
W 3 W S S W E W S W S W S W S W E W W
W W W W S W W W S W S W S W S W W W W
W W S W S W S W S W W W W W S W S W W
W S S S S S S S S 2 S S S S S S S S W
W B W S W S W S W S W S W S W S W B W
W S S W S W S W S W S W S W S W S S W
W S S S S S S S S 1 S S S S S S S S W
W W W W S S W S S W S W S W S S W S W
W W S S S W W W S W S W S W S W W W W
W W S S S W E W S W S W S W S W E W W
W W S S S W W W S W S W S W S W W W W
W W W W S W S W S W W W W W S W S W W
W S S S S S S S P S S S S S S S S B W
W W W W W W W W W W W W W W W W W W W